20 20 4 6
####################
#     #            #
#     #            #
#                  #
###                #
#                  #
#                  #
#                  #
#                  #
#                  #
#                  #
#                  #
#                  #
#                  #
#                  #
#                  #
#                  #
#                  #
#                  #
####################

